25 25
0 0 1  0 0 1  0 0 1  0 0 1  0 0 1  0 0 1  0 0 1  0 0 1  0 0 1  0 0 1  0 0 1  0 0 1  0 0 1  0 0 1  0 0 1  0 0 1  0 0 1  0 0 1  0 0 1  0 0 1  0 0 1  0 0 1  0 0 1  0 0 1  0 0 1  
0 0 1  0 0 1  0 0 1  0 0 1  0 0 1  0 0 1  0 0 1  0 0 1  0 0 1  0 0 1  0 0 1  0 0 1  0 0 1  0 0 1  0 0 1  0 0 1  0 0 1  0 0 1  0 0 1  0 0 1  0 0 1  0 0 1  0 0 1  0 0 1  0 0 1  
0 0 1  0 0 1  0 0 1  0 0 1  0 0 1  0 0 1  0 2 1  0 2 1  0 2 1  0 2 1  0 0 1  0 0 1  0 0 1  0 0 1  0 0 1  0 0 1  0 0 1  0 0 1  0 0 1  0 0 1  0 0 1  0 0 1  0 0 1  0 0 1  0 0 1  
0 0 1  0 0 1  0 0 1  0 0 1  0 0 1  0 0 1  0 0 1  0 2 1  0 2 1  0 2 1  0 2 1  0 2 1  0 2 1  0 0 1  0 0 1  0 0 1  0 0 1  0 0 1  0 0 1  0 0 1  0 0 1  0 0 1  0 0 1  0 0 1  0 0 1  
0 0 1  0 0 1  0 0 1  0 0 1  0 0 1  0 0 1  0 0 1  0 2 1  0 2 1  0 2 1  0 2 1  0 0 1  0 0 1  0 0 1  0 0 1  0 0 1  0 0 1  0 0 1  0 0 1  0 0 1  0 0 1  0 0 1  0 0 1  0 0 1  0 0 1  
0 0 1  0 0 1  0 0 1  0 0 1  0 0 1  0 0 1  0 0 1  0 0 1  0 0 1  0 0 1  0 0 1  0 0 1  0 0 1  0 0 1  0 0 1  0 0 1  0 0 1  0 0 1  0 0 1  0 0 1  0 0 1  0 0 1  0 0 1  0 0 1  0 0 1  
0 0 1  0 0 1  0 0 1  0 0 1  0 0 1  0 0 1  0 0 1  0 0 1  0 0 1  0 0 1  0 0 1  0 0 1  0 0 1  0 0 1  0 0 1  0 0 1  0 0 1  0 0 1  0 0 1  0 0 1  0 0 1  0 0 1  0 0 1  0 0 1  0 0 1  
0 0 1  0 0 1  0 0 1  0 0 1  0 0 1  0 0 1  0 0 1  0 0 1  0 0 1  0 0 1  0 0 1  0 0 1  0 0 1  0 0 1  0 0 1  0 0 1  0 0 1  0 0 1  0 0 1  0 0 1  0 0 1  0 0 1  0 0 1  0 0 1  0 0 1  
0 0 1  0 0 1  0 0 1  0 0 1  0 0 1  0 0 1  0 0 1  0 0 1  0 0 1  0 0 1  0 0 1  0 0 1  0 0 1  0 0 1  0 0 1  0 0 1  0 0 1  0 0 1  0 0 1  0 0 1  0 0 1  0 0 1  0 0 1  0 0 1  0 0 1  
0 0 1  0 0 1  0 0 1  0 0 1  0 0 1  0 0 1  0 0 1  0 0 1  0 0 1  0 0 1  0 0 1  0 0 1  0 0 1  0 0 1  0 0 1  0 0 1  0 0 1  0 0 1  0 0 1  0 0 1  0 0 1  0 0 1  0 0 1  0 0 1  0 0 1  
0 0 1  0 0 1  0 0 1  0 0 1  0 0 1  0 0 1  0 0 1  0 0 1  0 0 1  0 0 1  0 0 1  0 0 1  0 0 1  0 0 1  0 0 1  0 0 1  0 0 1  0 0 1  0 0 1  0 0 1  0 0 1  0 0 1  0 0 1  0 0 1  0 0 1  
0 0 1  0 0 1  0 0 1  0 0 1  0 0 1  0 0 1  0 0 1  0 0 1  0 0 1  0 0 1  0 0 1  0 0 1  0 0 1  0 0 1  0 0 1  0 0 1  0 0 1  0 0 1  0 0 1  0 0 1  0 0 1  0 0 1  0 0 1  0 0 1  0 0 1  
0 0 1  0 0 1  0 0 1  0 0 1  0 0 1  0 0 1  0 0 1  0 0 1  0 0 1  0 0 1  0 0 1  0 0 1  0 0 1  0 0 1  0 0 1  0 0 1  0 0 1  0 0 1  0 0 1  0 0 1  0 0 1  0 0 1  0 0 1  0 0 1  0 0 1  
0 0 1  0 0 1  0 0 1  0 0 1  0 0 1  0 0 1  0 0 1  0 0 1  0 0 1  0 0 1  0 0 1  0 0 1  0 0 1  0 0 1  0 0 1  0 0 1  0 0 1  0 0 1  0 0 1  0 0 1  0 0 1  0 0 1  0 0 1  0 0 1  0 0 1  
0 0 1  0 0 1  0 0 1  0 0 1  0 0 1  0 0 1  0 0 1  0 0 1  0 0 1  0 0 1  0 0 1  0 0 1  0 0 1  0 0 1  0 0 1  0 0 1  0 0 1  0 0 1  0 0 1  0 0 1  0 0 1  0 0 1  0 0 1  0 0 1  0 0 1  
0 0 1  0 0 1  0 0 1  0 0 1  0 0 1  0 0 1  0 0 1  0 0 1  0 0 1  0 0 1  0 0 1  0 0 1  0 0 1  0 0 1  0 0 1  0 0 1  0 0 1  0 0 1  0 0 1  0 0 1  0 0 1  0 0 1  0 0 1  0 0 1  0 0 1  
0 0 1  0 0 1  0 0 1  0 0 1  0 0 1  0 0 1  0 0 1  0 0 1  0 0 1  0 0 1  0 0 1  0 0 1  0 0 1  0 0 1  0 0 1  0 0 1  0 0 1  0 0 1  0 0 1  0 0 1  0 0 1  0 0 1  0 0 1  0 0 1  0 0 1  
0 0 1  0 0 1  0 0 1  0 0 1  0 0 1  0 0 1  0 0 1  0 0 1  0 0 1  0 0 1  0 0 1  0 0 1  0 0 1  0 0 1  0 0 1  0 0 1  0 0 1  0 0 1  0 0 1  0 0 1  0 0 1  0 0 1  0 0 1  0 0 1  0 0 1  
0 0 1  0 0 1  0 0 1  0 0 1  0 0 1  0 0 1  0 0 1  0 0 1  0 0 1  0 0 1  0 0 1  0 0 1  0 0 1  0 0 1  0 0 1  0 0 1  0 0 1  0 0 1  0 0 1  0 0 1  0 0 1  0 0 1  0 0 1  0 0 1  0 0 1  
0 0 1  0 0 1  0 0 1  0 0 1  0 0 1  0 0 1  0 0 1  0 0 1  0 0 1  0 0 1  0 0 1  0 0 1  0 0 1  0 0 1  0 0 1  0 0 1  0 0 1  0 0 1  0 0 1  0 0 1  0 0 1  0 0 1  0 0 1  0 0 1  0 0 1  
0 0 1  0 0 1  0 0 1  0 0 1  0 0 1  0 0 1  0 0 1  0 0 1  0 0 1  0 0 1  0 0 1  0 0 1  0 0 1  0 0 1  0 0 1  0 0 1  0 0 1  0 0 1  0 0 1  0 0 1  0 0 1  0 0 1  0 0 1  0 0 1  0 0 1  
0 0 1  0 0 1  0 0 1  0 0 1  0 0 1  0 0 1  0 0 1  0 0 1  0 0 1  0 0 1  0 0 1  0 0 1  0 0 1  0 0 1  0 0 1  0 0 1  0 0 1  0 0 1  0 0 1  0 0 1  0 0 1  0 0 1  0 0 1  0 0 1  0 0 1  
0 0 1  0 0 1  0 0 1  0 0 1  0 0 1  0 0 1  0 0 1  0 0 1  0 0 1  0 0 1  0 0 1  0 0 1  0 0 1  0 0 1  0 0 1  0 0 1  0 0 1  0 0 1  0 0 1  0 0 1  0 0 1  0 0 1  0 0 1  0 0 1  0 0 1  
0 0 1  0 0 1  0 0 1  0 0 1  0 0 1  0 0 1  0 0 1  0 0 1  0 0 1  0 0 1  0 0 1  0 0 1  0 0 1  0 0 1  0 0 1  0 0 1  0 0 1  0 0 1  0 0 1  0 0 1  0 0 1  0 0 1  0 0 1  0 0 1  0 0 1  
0 0 1  0 0 1  0 0 1  0 0 1  0 0 1  0 0 1  0 0 1  0 0 1  0 0 1  0 0 1  0 0 1  0 0 1  0 0 1  0 0 1  0 0 1  0 0 1  0 0 1  0 0 1  0 0 1  0 0 1  0 0 1  0 0 1  0 0 1  0 0 1  0 0 1  

2
0 20 280 445
0 19 232 589
1
0 0 0 9 1
$