25 25
0 0 1  0 0 1  0 0 1  0 0 1  0 0 1  0 0 1  0 0 1  0 0 1  0 0 1  0 0 1  0 0 1  0 0 1  0 0 1  0 0 1  0 0 1  0 0 1  0 0 1  0 0 1  0 0 1  0 0 1  0 0 1  0 0 1  0 0 1  0 0 1  0 0 1  
0 0 1  0 0 1  0 0 1  0 0 1  0 0 1  0 0 1  0 0 1  0 0 1  0 0 1  0 0 1  0 0 1  0 0 1  0 0 1  0 0 1  0 0 1  0 0 1  0 0 1  0 0 1  0 0 1  0 0 1  0 0 1  0 0 1  0 0 1  0 0 1  0 0 1  
0 0 1  0 0 1  0 0 1  0 0 1  0 0 1  0 0 1  0 0 1  0 0 1  0 0 1  0 0 1  0 0 1  0 0 1  0 0 1  0 0 1  0 0 1  0 0 1  0 0 1  0 0 1  0 0 1  0 0 1  0 0 1  0 0 1  0 0 1  0 0 1  0 0 1  
0 0 1  0 0 1  0 0 1  0 0 1  0 0 1  0 4 1  0 4 1  0 4 1  0 4 1  0 4 1  0 4 1  0 0 1  0 0 1  0 0 1  0 0 1  0 0 1  0 0 1  0 0 1  0 0 1  0 0 1  0 0 1  0 0 1  0 0 1  0 0 1  0 0 1  
0 0 1  0 0 1  0 0 1  0 0 1  0 4 1  0 4 1  0 4 1  0 4 1  0 0 1  0 4 1  0 4 1  0 4 1  0 0 1  0 0 1  0 0 1  0 0 1  0 0 1  0 0 1  0 0 1  0 0 1  0 0 1  0 0 1  0 0 1  0 0 1  0 0 1  
0 0 1  0 0 1  0 0 1  0 4 1  0 4 1  0 4 1  0 4 1  0 4 1  0 4 1  0 4 1  0 4 1  0 4 1  0 0 1  0 0 1  0 0 1  0 0 1  0 0 1  0 0 1  0 0 1  0 0 1  0 0 1  0 0 1  0 0 1  0 0 1  0 0 1  
0 0 1  0 0 1  0 4 1  0 4 1  0 4 1  0 4 1  0 4 1  0 0 1  0 4 1  0 4 1  0 4 1  0 0 1  0 0 1  0 0 1  0 0 1  0 0 1  0 0 1  0 0 1  0 0 1  0 0 1  0 0 1  0 0 1  0 0 1  0 0 1  0 0 1  
0 0 1  0 0 1  0 0 1  0 0 1  0 4 1  0 4 1  0 4 1  0 4 1  0 4 1  0 4 1  0 0 1  0 0 1  0 0 1  0 0 1  0 0 1  0 0 1  0 0 1  0 0 1  0 0 1  0 0 1  0 0 1  0 0 1  0 0 1  0 0 1  0 0 1  
0 0 1  0 0 1  0 0 1  0 4 1  0 4 1  0 4 1  0 4 1  0 4 1  0 4 1  0 0 1  0 0 1  0 0 1  0 0 1  0 0 1  0 0 1  0 0 1  0 0 1  0 0 1  0 0 1  0 0 1  0 0 1  0 0 1  0 0 1  0 0 1  0 0 1  
0 0 1  0 0 1  0 0 1  0 0 1  0 4 1  0 4 1  0 4 1  0 4 1  0 4 1  0 0 1  0 0 1  0 0 1  0 0 1  0 0 1  0 0 1  0 0 1  0 0 1  0 0 1  0 0 1  0 0 1  0 0 1  0 0 1  0 0 1  0 0 1  0 0 1  
0 0 1  0 0 1  0 0 1  0 0 1  0 0 1  0 4 1  0 4 1  0 4 1  0 0 1  0 0 1  0 0 1  0 0 1  0 0 1  0 0 1  0 0 1  0 0 1  0 0 1  0 0 1  0 0 1  0 0 1  0 0 1  0 0 1  0 0 1  0 0 1  0 0 1  
0 0 1  0 0 1  0 0 1  0 0 1  0 0 1  0 0 1  0 0 1  0 0 1  0 0 1  0 0 1  0 0 1  0 0 1  0 0 1  0 0 1  0 0 1  0 0 1  0 0 1  0 0 1  0 0 1  0 0 1  0 0 1  0 0 1  0 0 1  0 0 1  0 0 1  
0 0 1  0 0 1  0 0 1  0 0 1  0 0 1  0 0 1  0 0 1  0 0 1  0 0 1  0 0 1  0 0 1  0 0 1  0 0 1  0 0 1  0 0 1  0 0 1  0 0 1  0 0 1  0 0 1  0 0 1  0 0 1  0 0 1  0 0 1  0 0 1  0 0 1  
0 0 1  0 0 1  0 0 1  0 0 1  0 0 1  0 0 1  0 0 1  0 0 1  0 0 1  0 0 1  0 0 1  0 0 1  0 0 1  0 0 1  0 0 1  0 0 1  0 0 1  0 0 1  0 0 1  0 0 1  0 0 1  0 0 1  0 0 1  0 0 1  0 0 1  
0 0 1  0 0 1  0 0 1  0 0 1  0 0 1  0 0 1  0 0 1  0 0 1  0 0 1  0 0 1  0 0 1  0 0 1  0 0 1  0 0 1  0 0 1  0 0 1  0 0 1  0 0 1  0 0 1  0 0 1  0 0 1  0 0 1  0 0 1  0 0 1  0 0 1  
0 0 1  0 0 1  0 0 1  0 0 1  0 0 1  0 0 1  0 0 1  0 0 1  0 0 1  0 0 1  0 0 1  0 0 1  0 0 1  0 0 1  0 0 1  0 0 1  0 0 1  0 0 1  0 0 1  0 0 1  0 0 1  0 0 1  0 0 1  0 0 1  0 0 1  
0 0 1  0 0 1  0 0 1  0 0 1  0 0 1  0 0 1  0 0 1  0 0 1  0 0 1  0 0 1  0 0 1  0 0 1  0 0 1  0 0 1  0 0 1  0 0 1  0 0 1  0 0 1  0 0 1  0 0 1  0 0 1  0 0 1  0 0 1  0 0 1  0 0 1  
0 0 1  0 0 1  0 0 1  0 0 1  0 0 1  0 0 1  0 0 1  0 0 1  0 0 1  0 0 1  0 0 1  0 0 1  0 0 1  0 0 1  0 0 1  0 0 1  0 0 1  0 0 1  0 0 1  0 0 1  0 0 1  0 0 1  0 0 1  0 0 1  0 0 1  
0 0 1  0 0 1  0 0 1  0 0 1  0 0 1  0 0 1  0 0 1  0 0 1  0 0 1  0 0 1  0 0 1  0 0 1  0 0 1  0 0 1  0 0 1  0 0 1  0 0 1  0 0 1  0 0 1  0 0 1  0 0 1  0 0 1  0 0 1  0 0 1  0 0 1  
0 0 1  0 0 1  0 0 1  0 0 1  0 0 1  0 0 1  0 0 1  0 0 1  0 0 1  0 0 1  0 0 1  0 0 1  0 0 1  0 0 1  0 0 1  0 0 1  0 0 1  0 0 1  0 0 1  0 0 1  0 0 1  0 0 1  0 0 1  0 0 1  0 0 1  
0 0 1  0 0 1  0 0 1  0 0 1  0 0 1  0 0 1  0 0 1  0 0 1  0 0 1  0 0 1  0 0 1  0 0 1  0 0 1  0 0 1  0 0 1  0 0 1  0 0 1  0 0 1  0 0 1  0 0 1  0 0 1  0 0 1  0 0 1  0 0 1  0 0 1  
0 0 1  0 0 1  0 0 1  0 0 1  0 0 1  0 0 1  0 0 1  0 0 1  0 0 1  0 0 1  0 0 1  0 0 1  0 0 1  0 0 1  0 0 1  0 0 1  0 0 1  0 0 1  0 0 1  0 0 1  0 0 1  0 0 1  0 0 1  0 0 1  0 0 1  
0 0 1  0 0 1  0 0 1  0 0 1  0 0 1  0 0 1  0 0 1  0 0 1  0 0 1  0 0 1  0 0 1  0 0 1  0 0 1  0 0 1  0 0 1  0 0 1  0 0 1  0 0 1  0 0 1  0 0 1  0 0 1  0 0 1  0 0 1  0 0 1  0 0 1  
0 0 1  0 0 1  0 0 1  0 0 1  0 0 1  0 0 1  0 0 1  0 0 1  0 0 1  0 0 1  0 0 1  0 0 1  0 0 1  0 0 1  0 0 1  0 0 1  0 0 1  0 0 1  0 0 1  0 0 1  0 0 1  0 0 1  0 0 1  0 0 1  0 0 1  
0 0 1  0 0 1  0 0 1  0 0 1  0 0 1  0 0 1  0 0 1  0 0 1  0 0 1  0 0 1  0 0 1  0 0 1  0 0 1  0 0 1  0 0 1  0 0 1  0 0 1  0 0 1  0 0 1  0 0 1  0 0 1  0 0 1  0 0 1  0 0 1  0 0 1  

5
0 6 449 498
0 7 333 542
0 1 545 556
0 6 315 601
0 2 417 619
1
1 6 6 10 10
$